date,time,amount,type,balance,from/to
13-07-2023,11:15:59,0,0,100,bonus
13-07-2023,11:24:57,10,1,90,nbeqicjksa
13-07-2023,11:25:15,10,1,80,giftcard
13-07-2023,11:25:32,10,1,70,savings
13-07-2023,11:25:37,5,0,75,savings
13-07-2023,11:26:05,10,0,85,giftcard
13-07-2023,11:40:56,20,1,65,nbeqicjksa
13-07-2023,14:08:46,40,1,25,nithish
13-07-2023,14:08:46,40,0,65,nithish
13-07-2023,15:45:11,20,1,45,giftcard
13-07-2023,15:45:54,20,0,65,giftcard
13-07-2023,16:23:05,20,0,85,hari
